おまんまん	おまんこ
オマンコ	おまんこ
マンコ	おまんこ

オチンチン	おちんちん
チンチン	ちんちん
おチンポ	おちんぽ
オチンポ	おちんぼ
おちんこ	おちんぽ
オチンコ	おちんぽ
雄チンポ	おちんぽ
ちんこ	チンポ
ちんぽ	チンポ

しきゅ	子宮
アヌス	肛門
アナル	肛門
ザーメン	精液
せーえき	精液
じゃーめん	精液
せーし	精子

なからし	中出し
ながりゃ	ながら
なきゃに	中に

ち〇ち	ちんち
チ〇チ	ちんち
チ〇コ	ちんぽ
ち〇こ	ちんぽ
チ〇ポ	ちんぽ
ち〇ぽ	ちんぽ
マ〇コ	まんこ
ま〇こ	まんこ

小〇生	小学生
中〇生	中学生
〇リ	ロリ
〇〇の子	ロリの子
輪〇	輪姦
機械〇	機械姦
奴〇	奴隷
催〇	催眠
メ〇ガキ	メスガキ
メス〇キ	メスガキ
メ〇〇キ	メスガキ
〇〇ガキ	メスガキ


クソ〇キ	クソガキ

